変数移行表

顔にぶっかけたフラグ	顔にかけたＦ
胸にぶっかけたフラグ	胸にかけたＦ
お腹にぶっかけたフラグ	お腹にかけたＦ
初めてのキスフラグ	初めてキスＦ
フェラ中フラグ	フェラ中Ｆ
フェラ経験	廃止
フェラカウント	廃止
抱きしめ回数	廃止
胸イキ変数	廃止
胸イキ回数	廃止
フェライキ変数	フェラ射精変数
パイズリ中射精変数	パイズリ射精変数
パイズリ回数	廃止
パイズリ中フラグ	パイズリ中Ｆ
胸吸い経験フラグ	廃止
母乳プレイ経験	母乳プレイ体験Ｆ
顔うずめ回数	廃止
胸ころくりスイッチ	廃止
下着はいてないフラグ	廃止
挿入中射精変数	挿入射精変数
中出しカウント	廃止
中出し経験フラグ	中出し体験Ｆ
妊娠しちゃったフラグ	妊娠Ｆ
挿入カウント	廃止
挿入中フラグ	挿入中Ｆ
危険日フラグ	危険日Ｆ
ふとももはさみ中フラグ	ふとももズリＦ
手コキイキ変数	手コキ射精変数
手でしてもらった	手コキ経験Ｆ
危険表示した	精力危険通知
もうダメフラグ	マ体力危険通知
押し倒しフラグ	押し倒しＦ
マカナ立ち絵状態	廃止
処女フラグ	処女Ｆ
ユーザがダウンして終了	ユーザダウン終了
マカナがダウンして終了	マカナダウン終了
マカナ飲ザー好き度	廃止
マカナ胸愛撫好き度	廃止
マカナ中出し好き度	廃止
ユーザぶっかけ好き度	廃止
ユーザパイズリ好き度	廃止
自慰見ちゃった	自慰見た
堕胎フラグ	堕胎Ｆ
低好感度妊娠フラグ	廃止
子供成長日文字列１	子供成長日文字列
子供成長日文字列２	廃止
名前考えたかフラグ	名前考えたかＦ
出産	廃止
出産フラグ　廃止
堕胎経験	堕胎体験Ｆ
告白フラグ	告白Ｆ
食事イベフラグ	食事イベＦ
マカナ服状態	廃止
髪状態	後髪状態
おっぱいの大きさ	胸大きさ
授乳フラグ	授乳Ｆ
娘覗きフラグ	娘覗きＦ
赤子寝てるフラグ	赤子寝てるＦ
娘が出かけてるフラグ	娘外出Ｆ
娘が部屋に戻ってるフラグ	娘部屋内Ｆ
腹パン解放フラグ	腹パン解放スイッチ
過去の話フラグ	過去の話Ｆ
覗き用フェラ中フラグ	覗き用フェラ中Ｆ
覗き用マカナ絶頂フラグ	覗き用マカナ絶頂Ｆ
覗き用挿入中射精フラグ	覗き用挿入中射精Ｆ
覗き用挿入中フラグ	覗き用挿入中Ｆ
覗き用見挿入射精フラグ	覗き用見挿入射精Ｆ






＃＃＃反応
胸吸い廃止	乳首吸いへ
乳首勃起機能廃止




